11111111111
1E1C1000001
10010000001
1100000P001
1C000000001
11111111111
