1111111
1001PC1
101E101
1001001
1111111
